;--------------------------------------------------------------------
; https://www.autohotkey.com/docs/v2/Hotstrings.htm
;
; USAGE:
;    replacement | trigger | modifiers
;
; CHARACTER COMBINATIONS:
;    [abc] = one of these characters must be present at this position
;    [abc]! = one (or none) of these characters must be present at this position
;    [abc]+ = all of these characters must be present in any order
;    [abc]? = this phrase is optional
;
; MODIFIERS: (optional 3rd parameter)
;    * = an ending character is not required to trigger
;    ? = the hotstring will be triggered even when it is inside another word
;    C = case sensitive
;    C1 = ignore the trigger case and return the replacement as typed
;    B0 = turn off backspacing
;    O = remove the trigger character
;    R = send raw output
;--------------------------------------------------------------------


; .co.uk|[,.]co[,.]uk|*
; .com|,com|*
additional|additioal
all|a;;|?
boards|baords
boolean|boolaen
coming|ocming
cul-de-sac|coldasac
curly|culry
desktop|dekstop
ell|e;;|*?
end if|en dif
executable|exeutable
false|f[asl]+e
function|fuction
GDPR|GDRP|C1
general|geberal
handy|hnady
helpdesk|helpdeks
helper|herlper
; hotstring|ho[ts]+ring|*
ill|a;;|*?
install|in stall
integer|itneger
javascript|javascrtip
jquery|jquesy
little|litlle
loop|;oop
margin|maring
o'clock|oclock
obviously|obvisouly
of the|oft he
oll|o;;|*?
phoenix|pheonix
property|peroprty
querystring|quesystring
replace|relpace|*
return|retrun|*
sinecure|synecure
status|statsu
straight|stright
Thank|THank|*C
ull|u;;|*?
unsurprising|unsu[r]?pri[sz]ing|?
upper|uppser|?
Vodafone|Vodaphone
What|WHat|?C
Windows|WIndows|?C
Wonka|wonka|?C
Yeah|YEah|?C


;------------------------------------------------
; ADAPTED FROM wikipedia_common_misspellings.txt
;------------------------------------------------
statesman|stateman


;------------------------------------------------
; ADAPTED FROM wikipedia_common_grammar.txt
;------------------------------------------------
above-mentioned|above mentioned
all-inclusive|all inclusive
anti-inflammatory|anti inflammatory
award-winning|award winning
back-to-back|back to back
case-insensitive|case insensitive
case-sensitive|case sensitive
clear-headed|clear headed
co-op|co op
cross-reference|cross reference
day-to-day|day to day
de-emphasize|de emphasize
devil-may-care|devil may care
dirty-movie theater|dirty movie theater
ex-husband|ex husband
ex-wife|ex wife
father-in-law|father in law
fine-tune|fine tune
first-class|first class
front-rower|front rower
full-time|full time
left-handed|left handed
low-budget|low budget
mother-in-law|mother in law
non-English|non English
one-fourth|one fourth
out-and-out|out and out
out-of-band|out of band
out-of-body|out of body
out-of-bounds|out of bounds
out-of-door|out of door
out-of-doors|out of doors
out-of-order|out of order
out-of-place|out of place
out-of-pocket|out of pocket
out-of-state|out of state
out-of-the-way|out of the way
out-of-town|out of town
out-of-wedlock|out of wedlock
part-time|part time
pre-owned|pre owned
re-creation|re creation
re-sign|re sign
right-handed|right handed
self-evident|self evident
self-explanatory|self explanatory
self-proclaimed|self proclaimed
state-of-the-art|state of the art
top-notch|top notch
up-to-date|up to date
well-known|well known
X-ray|X ray


;------------------------------------------------
; ADAPTED FROM cdelahousse.autocorrect.txt
;------------------------------------------------
does not|doe snot
nineties|ninties
